11111111111111111111
10000000000000000001
101111E1100111111101
101000C0100100000101
10101010000000000101
10101P10100000000101
10111111100100000101
10000000000111111101
10000000000000000001
11111111111111111111
