11111111111
1P0C0000001
10C00000001
1100000E001
11111111111