111111111
1P0C00001
100000011
10C000011
1100000E1
111111111
