11111111111111111111
10000000000000000001
10111111100111111101
101000C0100100000101
1010101000001E000101
10101P10100000000101
10111111100100000101
10000000000111111101
10000000000000000001
11111111111111111111