11111111111111111111
10000000000000000001
10111111100111111101
10100E00100100000101
101000000000000C0101
10100000100C00000101
101111111001C0000101
10000000000111111101
10000P00000000000001
11111111111111111111
