11111111111111111111
10100001001000001001
10P00100000000000001
10001E00000110000001
100000000000000C0001
10000000000C00001011
110C10010000C0001011
10010100011000000001
10000000000000000001
11111111111111111111
