1111111111111111111111111111111111111111111111111111111111111111111111111111111111111111111111111111
11000000000000C000000000000000000000001C01000000C0010100C000000000100000000CC0000100C00C00C000C10C01
10000P0C00000000CC00010001000000000100000000000100100000000001000000010C100000000000010000CCC0000001
100001000000C00100000000000000000100C00C0000100000000001000010000C0000000000000010000000000000000001
100010000000C00100100011000010000000010000100100C010000C00001100C0000000000C000000000100000010000001
1C00000000000000100000000001010000000C0000011100000000000001000000000000C01000C00000000000C100000001
100110000000C000100C00000000000010100C0000000000000000000010000C000001000000000000000000100101000011
10000001000000000010C0000000000100000C00011000001001000000C00000100000C000000000000010C0000001000001
1000100000000000000C0001000100000000001C000000000000000000010000000C00000100001100000001000011000001
10100010000000000000C0100010000000000C0010100000000000000010000000000000000000C0000000100100CC000011
1000001100001000C0000100000101C00000000000100000000000101000000001000100000000C0000000000000CC000001
11000000000C00C000C000000101000000000010C00C00E00000001010000000000C01100000000000C00000C000C1000001
110000001000C0100010000000C0000100000100100000000110CC10000000000100000001100000C0000000000001000001
11000C000000000000000001000000000000C10000C000000011CC00000000000000001C00C0000000100C0000000C010001
10000000001001C0000000000010000000000000000000000000000000101000000000000000000000000100C10000000001
1010000C01C000C00C0C00000C00001001100000000C010000000C000000000000000000010000100C0C0001000000000001
10011000C00000000011000010000000000000000000000001000C0001000010000000010000C000000000000000000000C1
10C0000000000C0010100000000000000000000000000000000010000001000C00000100000C100000000000000000010001
1000000C000000000001000000C1000000C0000000C00000000001000000000010C01000000010000C00000001C101010001
1000000000000000010011100000000010000000000000C0001000100C001100100000000000000000000000010000000011
100100000000000001C00011C000010000000010000000000000100CC0010000000000000000000000000C00000000001001
1000000000000000000000000000000000000010000000C00000C00000C00001000100000100001010000000000000000001
100000C000C00001000C000001000000000010000100000000000000C000C10000100000C000001000000000000000000001
100000000C00000000001C0000000000000C0000000000000C000000000000000C0000000001000000000000000000000001
100010000000100010000000000000000000000010000010000C000000000000C00000C00000000000000010000110000001
101000001000000C100000000000010101000CC000000000C0110001000000000000000000000100000000001000000CC001
1C10001010001000000000C000001101001000000000000010000000000100C1000000C00000000010000001000000000001
100000000000000000C00C000000000001C000000000000000010000000100CCC0000010000000000C0000C00000C0000001
1100C100000010000000101000000C001001C0110100000000000000000C00000000000C00000000000010C0000000000001
11000C0000000000001000000010000000000000010C000000000000100000000001000000C00C0000000000100000101001
10000C0101000000000000000010010000C0000010CC0C100000000101C1000000000000C000000000000100100000C10001
10110CC00C000000001000010C001000C00000000000000C1000000000100010000000C0100000000C00C000000001000001
100C0C0010000010101000000100100100000000000100000000000000000000C01000100000100000000010001000000001
1000C0000000000C0000C00000011100000000000C000000000000000C10C0C000001000C0C0100000000000000000000001
100C1000CC00010000C010001C00001000000000101100000000010000010001001000000000000000000000000100C00011
10010000000000000000000C000000000000C00000C0001000000101100001000000001010010C0000000000000000000001
100000000000010000000000000001000000100000000000000000000000000001000000100000C000C01000100101000011
1000100C000001000C0C000101000000000C10CC00C00000C00001000000000000C0101C0000000000000100000C10000001
1000101000000000010C0100000000C010100001001C0000010C001C01000000000000011000000100100000000000011001
1001001000000000000C000010000100000000000000000000100C00100000010001000110100000000C000000000C000001
1000000000000000000101000000000C100C0010000000000000000000000000000000C1000000001000000001C000C0C001
10C00000C00C0010000000000C00111000001C0C0000000000000C000CC01000000000010000000000000000000000000001
1000011000C00C000001000000000010000C00000000101011C000100000000000000000C000000000000000000C10001001
1000000000C00000100C10000001000010000000100000001000100011000CC1000C001000000000000000C1000000000101
10000010000000010000010010000101000000C00C00100000C0100100000000000000000001000000000000100C00C00001
10000000100C0000000000000000000000000C000000000000C00000000000000011000C0010000001010000010000000101
1000000000000000110000000000000000000000000000000000000C00000C10000000000000000100001000000000000101
1C0000000000000000C000000001000001000000C01000000000000000000000010000000000000000000001000000100001
10000000000C001001100C01000000000000010110010000010000100000000000000000010000C00C000000000000000001
1C0000C000000000000001000C0000100100000000000000000C0000010000000000000000C00C00000C0000000000100001
10C00C000000CC0100000000C0001000000000000000000000001CC001C00001000001C0000010C000000000000000000001
100001000000100000001110C00000000000C00000000C001000000100101000000010000C00000000010000C00001000001
110000000000000000000110010000C0000C00100C00000000010C0000100000000C100C00100001C0000000000000000C11
1001010000000001000000C0001000100011CC00000C00011000100C0000100100000000011100C0C1100000C000100C0001
10001000000000000110000000100000100000000000000000100C000000C00000000000010000000C0000C0C00110010001
10C0001000000000000100000100C001010000001000000000000100000000000010000100000000000C00000000C0C000C1
1000000000000000000000001000000C00001000000110000000001001000100000001100000000000000000C00000000001
1000000000010000000000000C000000000C00001000000C0C0100000100C000100001100000000100000100000000100011
10000C100000000010000000100000000000000000C010C000000001000000000C0001000000000100000000000000000001
100000100000001000000000000100000C100000C00010C01001000000C0000000000001000000000C000000C0000C000001
10C100C000C010001000000C0000010011010010010000000C000100100000C000000010C00100C000000000000000100001
100000000C1000000C00000000000000000001C101000000100C00000001000000101000000000100000C010000000000001
10000000C10000000000C1000100010C0C00000010000000000000000100010000C0100010000000000000001000C0000001
100001000C0000000001010010000000000000000000000000001000000C000C00000000C000000000C00000010000000001
1000000000100C000100000010000C000000000010000110C00000000C00000000100C000000000101000000010000000001
10000010000101000000000100C0001000000C0000000000000000C0100C01000000C01000000000010010C0000000000001
10C011000C0000000C00010000001000000010C0000000000000010000C0001001000001000C001C00010000000001000001
10100000000000000000C000000000000100000000000100001C0000001000C0C00000C00000000000000000100C000000C1
100000000000000000000C000100000000010000000000001000001C00000000000000010100000000000010000010001001
100001000100000C010C0000000001000000000C1C000000C000000000000001000000C00010000001000000100000000001
10100C000010100001000000000010000000000000000010000001000000000010001010001000010100000000C00C000101
100C0011000000001000000100000C0C0C00000000000000001000110000001C0000000001000000000000C11000C0000001
1000C0000000C010000C000010000C000001000000000000000000100001C0000000011000010C0000001000000000000001
10000000000000000010011000000010010000000000000001000000000000100C00000C0000C00010000000100000C00001
1000000C001110000001000000100000C100000100000000000010100000000000000000C0000000001101100000C0000001
10000000001000000010C00C00001010000100000C01000000000000000000000101000000000C0100000000000000000001
100000001000000100C00000000000000000000010000C00000100000CC00000C00000000C00000000001000000C0000C001
1101000C0000000000001100000000000C000000000000000000C000000000000100000000C0010001000000000000000001
10100CC0000000C000C0100000000000000000000000000000000000CC10000000000C0000000C01000C00C0000110000001
10000C00000000000000100000000100101000000010C000000000C001010000100010010000000CC00000000100000C0001
100000000001000000000100000C0001001010C0C000000000000C0000010100101000000C00000100000001000000000001
100000000000000000000100000011000C00100000010000000C10000000001000C010010000100000C000000C0100000001
10C010C000001000C0000000000C0100000000000C0C0000010000000C010000001000000000000100000000001011000001
10100000000C0000000010000C0C00CC00010C00C00000000C0000C00000000001000000C000000000001000000100000001
10C0000C10001110010C00001C000010000000000001000000000000000000C0000C00100001000111100000000000000001
10000000000000000C000000100100000C0C00001000000000000000C010010000000C000010001010C0000000000CC01001
100000C000000010000000001C00C000000000000010100000000010000000000110000001000100010000000100000100C1
1C000100001C000C00000C0011010000000000000010000000C00010C000000000000000101000C0100000C0000000001001
10000C00001000000C010000000C000000000000000000010C0001000000000CC11C000000C0000000000000000000000001
11001000001000000000C0010000000C000CC100000000000001000000000000100000000000000010000000000000000001
1001CC01000000000010000000C000000000010010000001000000000CC00010C0C00C011C000000000C0000100000000001
1C0000000C000000001000000000000100C00000000000000000000000000000000C00110000001000000000CC0000000001
10000001110000000010000000000000100000000000C010C00010000000000000000C000100000000C0000C010010000001
100000C01000000010000101000000100000100000010C0010000000000000C0000010000000100000C00000000000000C01
1000001000001C100000000000000C100C0C000000C00000000010100000C000000001000000C0C100000000000110C00101
10100001000000000C0000100C010010000C0000100000010010100000C010000000000000100C00000010000000000C0001
1000000001C0010000C00000C000000C10000C1010100010C0001000000000000100000000010000C0010000000001000001
10000000C1C01000C1000100000000000010010C00001000001010C000000010000001000000000000C00000000010000001
1001001010010000000000C000000011000000000001000000000000001100000000000100C0C00000000000000001001111
1111111111111111111111111111111111111111111111111111111111111111111111111111111111111111111111111111
