1111111111111111111111111111111111111111
1000000000000000001000000100001000000001
1000000000000000000010000100010000000101
1000000010000001001000000100000000000011
1000001000000000000000000000000000000001
1010001000000000000000000000000000000011
100000010000000010010010E000010001000001
1000000000000000000100100000011000000001
1000100000000100100011000000000000000001
1000000000100000000000000000000000000001
1000000000010010000000100000000000000001
1000000000000000000000101100000010000001
11000010001001000000P1000000000000000111
1000001100000011000000000000001010000001
1000000000000001000000101000110000000001
1010000000000000100000000001000000000001
1010000000110000000001100000000000000001
1001000000000001001000000000001001000001
10000000000000000CC001000010010000010001
1111111111111111111111111111111111111111
