1111111111111111111111111111111111111111
100C0000000C0000001C00000100001000000001
100000000000000C00001000C1C0010C00000101
10000000100000C1001000C0CC100000C0000C11
100000100C00000000000C0000C00000C0000001
1010001000C0000000000000C000C0000000C011
100000010C0000C010010010EC00C100010C0001
100C000000000000000100100000011000000C01
1C0010000000010C1C0C11000CC0C0C0C0000001
10000000001000000000000000000000000000C1
10000C0000010010C000C01000000000C0000CC1
100C00000C00000000000010110000001000C001
11C00010C010010000CC0P1C0000000000000111
10000011000000110C000CCC0000000010100001
100000000000000100000010100CC11000000001
10100C0C00000000100C000000010000000C0001
1C10C00C0011000CC00000110C000C0000000C01
10010000C0000001CC01000C0C0000010C100001
10000000C00C00000CC001000010010000010001
1111111111111111111111111111111111111111
