111111111111111111111111111111111111111111111111111111111111
1000000000100C0010000010000000000100001000000010010000010001
100000000001001000000000010010000000000000000000100000000111
1000100010000000000000000101100010000000000000000C0000000001
1000000000000100000001C00000P0100010000000000010000100000001
10010000000000000000C1000000010001001001000C0000000100000001
10000000000000000000000000000100C000000000000000010000000001
10C00011000000000011000001C000000100000000000000000000000001
100000100000000010000000000000000000100000000000000100C00001
10010010000000000000110001000000000000C000001C00000000000001
101010000000000010000000000000000100100010001000000000000001
10000000000100000C000001000000000000000000001001000000000001
1000000C0000000000000000000000000001000001001000000100000001
100001000000C000000100001000010000000000010CC011000000011011
11000000000E00000000100100000000000001000000000010000C010011
100000010000000010000001000000000001000000000001110000001001
100000000000000000000000100000C10000100000110100C0C000000001
100100000001000000000000001001000000000101C00000000010000001
1100000C000000000000000000000010001000000C001000000100000101
10000000000000010000000000100000C100000000010000000100001001
1000000001000000000000000000C00000110000000000000C0000000001
1000100000001000100000001000C0000C00000000001001000000010101
101000001000001000000000001000001000000C00010C00000000000001
110000100001000000000001000000000000000000000010000000000001
100100000000000000000001000010000100100000100100001000000101
1C00010000001000000000000000010000110100010000000C1000000001
110000000000000000100000000000000000000000010010000000000001
100001000000000001000000000000000000100000000000100000000001
1000000C1101001000000010010000000011100000000000C00110000001
111111111111111111111111111111111111111111111111111111111111
