111111111111111111111111111111111111111111111111111111111111111111111111111111111111111111111111111111111111111111111111
1C0000000C000000000C00100000000000CC000000000C000100000000C000000000C0000000000000000000000100000000111000000CC000010001
100000C0000001110000C001000000000000000000C0000000001000C00000010000C000010C001000001000C000001C0100000C000C000000000C11
10000C000000C0010000000100000000000C00000000000001000000000010000000100001001001000000100000010C0100000C000000000000C001
1C00C00000000000000000001000010000000C00000000000C00C10C0000000011C000110000000000010C000000000C0C10000C0010000011000011
10C00CC000000000000000000001C00000C000100000000000000000000010010C00000000000000000001C0000000000C0000000000001010000101
10100000C000000000001000001000C000001000100C00000000000100000100C00C000001000000001100000C000C00000000000000000000000C01
10C000000001C001000C000001000CC00C00000000000C000000C010000000C00000000001010000000000010001000000C000000000100000000001
100000C01100000000000000CC0C0000001C000010C000000001C0001C0000000000000100C00100000000C0000000000001000C0010000001000001
10C000010000C0001C0C000001000000101000C000001000C000000000000000C00001000C0100C000C0100000000000111000011000000100000001
1CC10CC000C010000C00000C00000000000101C00010100000100000000C000000C00000C00000000000C00001001000C00110000000100CC00000C1
10001000000000001100001C0010001000C0000C000000000000010C00000100C0000001000100000100C0000C000010C01100010C00000000000011
10000000000000000000100000000000000000000000C0000010C0000C0000100000100C0000000000001000C000000000100CC0000CC00001010001
1C1000001000000C00000100100000000C00C0C00000010C00C001000000011000000000000000010000000000100100000000100000000000000C01
11000000011001000000000C1000000000C00000000000000000000C00000010C0010001010C00000C0C0000000000000000000000C00001C0001001
1000001000000C1000100000000C0C1000C00C00000000000000000C000100000C00000000C00001000000C000010000000000000CC1000000000001
10000000000001C00000000000C000010000C010001000C00000000000000000000000000000101100000100100000101000011000010C00000C0001
100000C000010C001000C000C00100000001000CC0C010000001011000010000C00C00000000000000000000C000010100C00C000000111000000101
1000000C00000C00000000000000000100C00000000C0000C001100000000000C000000C100000011000010000000CC0110100000C00000000000001
1000C0000C1000000011000C100000C001010C0000000C000000C000000C000000001C0000100000010010C01000C1000100000000001000000C0001
100000CC1000C100C0C0000000000000000010000000110100000000000000000100C0000C00CC00000010010000C000000000000000000000010011
100C0000010010000000000010C1100000000000C100000000000000000CC011001000000000C0C0C11C00000000010000C0000001C0C1C000000C01
1C000001000C10000000000100010100000CC00C00000001000C100000000000000010000000000000000000001001C1000001C00000C00010010C01
100000C0000000000000000000110000001000100001000000C00100000000000000000000000000000000C00C0000C000100000000000C000001001
10C0000000C0000000000001C0100010000000000C0100000C0CCC00000C00000C1000C0C0000000000C000C010000001C00000000C00000000CC001
1C000000000000100C000000000CC000C10100000011000001001C000C00000000CCC0000C000C010000C0C01000100000C0000000001000C0000001
10000010100C000010CC00000000C0100C10100C00C000110000000000000000001000100000C0010C0000110000000001010110000C0000001C0001
10000100000010C00000C0001000000C0C00000100001000110000C00000010000000000000000000100C00000C0000000C00000000C000000000001
100000000000000C1010000C00101010C0C000000000C0000CC00010000C0100C0C00000000000C0000000000000100110010000CC00000000000001
10000000C1110000000001000000000000010010000000000000100C00100000000010000000000C01010000000C00C1000000000010010C000C0001
10000100C0CC100100C10C000C00C00C00000C10000000000000000000000001000010C00C011010000000C10100000000000010010001C000000001
1000000000001CC00000000000001000010000C00100000000000C010000000C00000000000000000C000000000000000000010000001C0000000001
110C00000000000000100C010000000000C000000000001100000000C0C011000C100000000100C10000000000000000000000C00000000000000001
100C000010000C000000000000000C1000000000000000000000000010C00001001000C000000001001000C00C100100C00C1100000010000000C0C1
1000000000000100000000000C10000C0000011C1000C000C0000C00000000000001100C01100000000C0001100000100001000C0C0001000C000001
10CC0010000110000101000C0C00000000000000001000CC010000000C100000000C00000001C0001100000000000C00000000000000000000000001
1100000C00C00C1000000100100000010C100000000000000000000000000C0C0001C0010C0000000001000000000000001100000100000C00000001
11000000000000000000000000C000000C0000C1001C010101C0000000000000C001010000000C00001000110100C0000000C0000001C00000CC00C1
1C0100000001000000000010010C00000C000100000000C000000100C0000000000000000C00C0001000000000000000000000000C0C0000C0000001
100000C0E010C00000000C0000000000010001C0010110000000000C000000C0100101C0000001000010000000000010C0000000C1001C000C000001
10C00100000000100C000000010000C000000110000000000000C0C110000000000C0C000000CC10C0000000000010C0000000C10001000000000001
10000001000000C000001000C11C01000000000000C010000110C100010010100C0000000000010000000000000000000010C0000100C00000000001
100000000CC000000CC10000000000C100001000000000010000000C000010000000C001000000000000000C000000000000010000C0C10000001001
1000000000000000000010C010000000000C00010000000C10000000000C000000100C00100C010000C0C010100C1010000000000000000000000001
1000100001000100C000000000000000000000001C00C00C000010000C00000001C00010000000100C0000000C000000001000000001CC000CC1C001
1000000010000000001000C000000000C00000000C0000100C0000000100000100000000000C0001000000000100000000000C0000001C0000000001
10C00010000100C000000000100000001000100000001000000000000000C00000100000000000001C010C00001100000000C101C000000100C00011
1C00011000000000010001P0C10000000000C00010000000000000000000000000C1000000000000C000001000C00000001001000000000000100101
10000000000C00000000000000C010000010001000000000000C00001000001000000C0C000000C0000000000001101000001CC00000000000000001
100000100000000100C00001110100000000C0010000000001000000001C0000000010000001001000000000000000C0000000C00000000000C00C01
1000000000010000000000000000101C000000000000C0000000000C000CC0000000100000000C000000000000C0000000C000000000C000010000C1
1C00010010000C0001000010C001110000110001000000C00000010000000C000000C0000000000C0000000C000100000000C011000000000000C001
10C10000100000000CC1000000C00000000000C000000000100100000C100C00000100C000000C00C00001000000000000110000000C000000000001
10C1000000000C01C0100000000000000C000100000010C00010C10000100C000001000001000000CCC0000000010000000100100000000100000101
10001C11000000000C000100010000000000C0100000C11000001000000000000000C00000C0000000000000011C00000000000100000C000C001011
10CC0100000000000000C0C000000000000C011000010000000000C0100000C000C0000101100000010C00000C000C00011C000000000000000C0001
1000001CC0000000000000000C0000C00001C0000C0000010000111100000000000000000000C001010000100C0001C0000000010C00000000000101
10000000000000000100C01001001001CC0001001CC0000000000000C000000C0010C00000000000100C0CC00C0C0000000C00000000100001000001
1000C0C0000100000010C10C100000010000000C000C00000000C1100010C000000000C0000000000100000010C000000C00C00000000C0100000001
1000100000010000000000000000000000010000C001100000000000C0000C00C1100010C000CC110C100000000001C000C000000000000000000001
1001100000000010C010000000100100C01000C00000C000000000C0000C00C00000000010C0010100000001000100000000C0101000000000000001
1C00000000010CC0C000C000000C0100000CC0000000000100CC0001C01000C001011000C00000C000010000C0010100000C010C10CC000C00000C11
111111111111111111111111111111111111111111111111111111111111111111111111111111111111111111111111111111111111111111111111
