11111111111
10000P00001
1000C000001
111111E0111
11111111111
